月平均,全區平均氣溫,全區騎乘紀錄筆數(次數)(去除36筆超過24小時),年約會員(Subcriber)全區騎乘紀錄次數,短期會員(Customer)全區騎乘紀錄次數,全區騎乘紀錄筆數(次數)(超時收費筆數)
九月,68.60 ,1821,1598,223,113
十月,65.87 ,1775,1569,206,95
十一月,57.17 ,1415,1237,178,63
十二月,54.65 ,860,803,57,27
一月,51.71 ,1317,1208,109,64
二月,57.75 ,1373,1166,207,84
三月,61.06 ,1539,1313,226,102
四月,59.70 ,1463,1267,196,75
五月,60.97 ,1485,1240,245,103
六月,68.00 ,1682,1360,322,110
七月,70.52 ,1678,1396,282,89
八月,71.48 ,1512,1275,237,74
